アルバート	阿尔伯特	name
アル	阿尔	name
マコト	真琴	name
マクドガル	麦克杜格尔	name
イズミ	泉	name
レイコ	玲子	name
シェリル	谢丽尔	name
カイル	凯尔	name
マルチナ	玛缇娜	name
ティーナ	蒂娜	name
シルビア	西尔维娅	name
カズミ	和美	name
クリス	克里斯	name
エレナ	埃琳娜	name
グスタフ	古斯塔夫	name
ゲーツ	盖茨	name
放送の声	放送声
男の人	男人
編集長	編集長
女性声	女性声
オバサン	オバサン
女の子	女子
窓際の女性	窗边的女人
男の声	男声
女の人	女人
ツナギの女	ツナギの女
少女	少女
女の声	女声
通りがかりの男	路过的男性
見知らぬ女性	陌生的女性
アル・レイコ	阿尔・玲子
ティーナの声	蒂娜的声音
ブラザー	布拉尔	name
シャトレート	夏特拉特	name
グランチェスタ	格兰切斯特	name
クサナギ	草薙	name
クリスティ	克里斯蒂	name
シェパード	夏帕多	name
フランソワ	弗朗索瓦	name
カーツ	库尔茨	name
ゲイツ	盖茨	name
ステラドビ	斯特拉多维	name
デザイア	DESIRE